Title	Complement	POS_1	Definition_1
Աբաս	ի, այ, աւ	np.	Abas.
Աբգար	րու, աւ	np.	Abgar.
Աբգարոս	րու	np.	cf. Աբգար.
Աբդիաս	դիայ, դիու	np.	Abdias.
Աբեններ	րայ	np.	Abner.
Աբեսողոմ	մայ	np.	Absalom.
Աբէլ	լիւ	np.	Abel.
Աբիա	այ	np.	Abia.
Աբիադար	րայ	np.	cf. Աբիաթար.
Աբիաթար	րայ	np.	Abiathar.
Աբիմելէք	քայ	np.	Abimelech.
Աբիսակ	կայ	np.	Abisag, Abishag.
Աբիրոն	նայ	np.	Abiron.
Աբուբեքիր	րայ	np.	Abu Bakr.
Աբրահամ	մու, աւ	np.	Abraham.
Ագաբոս	սիւ	np.	Agabus.
Ագագ	գայ	np.	Agag.
Ագաթա	այ	np.	Agatha.
Ագաթանգեղոս	ի, սիւ	np.	Agathangelos.
Ագաթոկղէս	ղի	np.	Agathocles.
Ագամեմնոն	նիւ	np.	Agamemnon.
Ագար	րայ	np.	Hagar.
Ագեսիղայոս	սիւ	np.	Agesilaus.
Ագնէս	նեսի, նեսաւ	np.	Agnes.
Ագրիպպաս	պայ	np.	Agrippa.
Ադամ	մայ	np.	Adam.
Ադոնիա	այ	np.	Adonijah.
Ադոնիբեղեկ	կայ	np.	Adonibezek.
Ադրիանոս	սիւ	np.	Adrian.
Ազայէլ	լիւ	np.	Azazel.
Ազարիա	այ, այի	np.	Azariah, Azarias.
Աէտիոս	սիւ	np.	Aetius, Aetios.
Աթանագինէ	նեայ	np.	Athanagenes.
Աթանաս	սիւ	np.	Athanasius.
Աթենաս	այ	np.	Athena, Minerva, Pallas.
Աժդահակ	կայ	np.	Astyages.
Ալբերտ	տի	np.	Albert.
Ալեքսիանոս		np.	Alexios; Ալեքսիոս Կոմնենոս, Alexios Komnenos.
Ալփոնսոս	սիւ	np.	Alphonse.
Ակակիոս	սիւ	np.	Acacius.
Ահարոն	նիւ	np.	Aaron.
Աղեքսանդր	ի, ու, աւ	np.	Alexander.
Աղկիբիադ	դեայ	np.	Alcibiades.
Ամազունք	նից	np.	Amazons.
Ամաղէկ	կայ	np.	Amalek.
Ամբակում	մայ	np.	Habakkuk.
Ամբրոսիոս	սիւ	np.	Ambrose.
Ամիլկար	րայ	np.	Hamilcar.
Ամինտաս	այ	np.	Amyntas.
Ամոն	նայ	np.	Ammon.
Այաքս	սայ	np.	Ajax.
Անակ	կայ	np.	Anak.
Անակլետոս		np.	Anacletus.
Անակղետոս	տեայ	np.	cf. Անակլետոս.
Անակրէոն	ակրէոնի	np.	Anacreon.
Անահիտ	հտայ	np.	Anaïd, Diane.
Անան	նայ	np.	Anan.
Անանիա	այ, այի	np.	Anania.
Անաստաս	սայ	np.	Anastasius.
Անաքարսիս	րսեայ	np.	Anacharsis.
Անաքսագորաս	րայ	np.	Anaxagoras.
Անաքսարքոս	սիւ	np.	Anaxarchus.
Անաքսիմանդրոս	րի	np.	Anaximander.
Անաքսիմենէս	նեայ	np.	Anaximenes.
Անգեղոս	ղեայ	np.	Angelus.
Անգէոս	գեայ	np.	Haggai.
Անդրեայ		np.	cf. Անդրէաս.
Անդրէաս	րէիւ	np.	Andrew.
Աննա	այ	np.	Anne, Hanna.
Աննիբաղ	ղայ	np.	Hannibal.
Անտենոր	րայ	np.	Antenor.
Անտիգոնոս	նեայ	np.	Antigone.
Անտիոքոս	քայ	np.	Antiochus.
Անտոն		np.	Anthony.
Անտոնիոս	նիւ	np.	Anthony.
Անտոնինոս	սիւ	np.	Antoninus.
Աշոտ	տոյ	np.	Ashot.
Ապեղէս	ղեայ	np.	Apelles.
Ապողինար	րիւ	np.	Apollinaris.
Ապողոդորոս	րայ	np.	Apollodorus.
Ապողոն	նիւ	np.	Apollo.
Առաքէլ	լայ	np.	Arakel.
Առաքել		np.	cf. Առաքէլ.
Ասթինէ	նեայ	np.	Vashti.
Ասկանիոս	նեայ	np.	Ascanius.
Ասկղեպիադ	դեայ	np.	Asclepiades.
Ասկղեպիոս	պեայ	np.	Asclepius.
Ասողիկ	ղկան	np.	Asoghik.
Աստղիկ	ղկան	np.	Aphrodite, Venus, Lucifer.
Աստուածատուր	տրոյ	np.	Deodatus.
Աստրուբաղ	ղայ	np.	Hasdrubal.
Ասդղուբաղ	ղայ	np.	cf. Աստրուբաղ.
Ասքանազ	զայ	np.	Ashkenaz.
Ասքանաս		np.	cf. Ասքանազ.
Ատովմ	մայ	np.	Atom.
Աստիագէս	գեայ	np.	Astyages.
Ատտիկոս	սիւ	np.	Atticus.
Ատտիղաս	սայ	np.	Attila.
Արամ	մայ	np.	Aram.
Արամեանք	նց	np.	Armenian.
Արայ	յիւ	np.	Ara.
Արբակ	կայ	np.	Arbaces.
Արետ	տայ	np.	Aretas.
Արէս	սիւ	np.	Ares, Mars.
Արիոս	սիւ	np.	Arius.
Արիոսթօ	օյիւ	np.	Ariosto.
Արիստակէս	կեայ	np.	Aristaces, Aristakes.
Արիստարգոս	գեայ	np.	cf. Արիստարքոս.
Արիստիդէս	դեայ	np.	Aristides.
Արիստիպպոս	սիւ	np.	Aristippus.
Արիստոտէլ	լիւ	np.	Aristotle.
Արիստոփան	նեայ	np.	Aristophanes.
Արիստոքսենոս	նայ	np.	Aristoxenus.
Արկադէոս	դեայ	np.	Arcadius.
Արկեսիղայոս	ղեայ	np.	Agesilaus.
Արմայիս	սայ	np.	Armais.
Արմենակ	կայ	np.	Armenak.
Արշակ	կայ	np.	Arsaces.
Արշակունիք	նեաց	np.	Arsacid.
Արշամ	մայ	np.	Arsames.
Արսէն	նիւ	np.	Arsenius.
Արտակ	կայ	np.	Artak.
Արտաշէս	շիսիւ	np.	Artaxias, Artashes.
Արտաշիր	շրիւ	np.	Artaxerxes.
Արտաւազդ	դայ	np.	Artavasdes.
Արտաւան	նայ	np.	Artabanus.
Արտեմիս	մեայ	np.	Artemis, Diana.
Արրիանոս	նեայ	np.	Arrian.
Արփաքսադ	դայ	np.	Arpachshad, Arphaxad, Arphacsad .
Արքեղայոս	սիւ	np.	Archelaus.
Արքիմեդէս	դեայ	np.	Archimedes.
Աւգոստոս	տեայ	np.	Augustus.
Աւրեղիանոս	սիւ	np.	Aurelian.
Ափրոդիտէ	տեայ, եաւ	np.	Aphrodite, Venus.
Ափրոդիտէս	տեայ, եաւ	np.	cf. Ափրոդիտէ.
Աքաաբ		np.	Achab.
Աքազ	զու	np.	Achaz.
Աքիա	այ	np.	Ahijah.
Աքիմելէք	քայ	np.	Achimelech.
Աքիովր	րայ	np.	Achior.
Աքիւլլէս	լլեայ	np.	cf. Աքիւղէս.
Աքիւղէս		np.	Achilles.
Բաբ	բայ	np.	Bab, Babus.
Բագարատ	նեաց	np.	Pancratius, Bagarat, Bagrat.
Բագրատունիք	նեաց	np.	Bagratid.
Բաղդովինոս	նեայ	np.	Baudouin.
Բակուր	րայ	np.	Bakur, Pacorus.
Բահաղ	ղու	np.	Baal.
Բաղաամ	մայ	np.	Bal'am.
Բաղակ	կայ	np.	Balak.
Բաղտասար	րայ	np.	Balthazar, Belshazzar.
Բայազիտ	տիւ	np.	Bajazeth, Bayezid.
Բառնաբաս	այ	np.	Barnabas.
Բասիլիոս	սիւ	np.	cf. Բարսեղ.
Բարաքիա	այ	np.	Barachias.
Բարթողիմէոս	մեայ	np.	Bartholomew.
Բարշամ	մայ	np.	Barsamin.
Բարոնիոս	սիւ	np.	Baronius.
Բարուք	քայ	np.	Baruch.
Բարսեղ	սղիւ	np.	Basil.
Բաքոս	սիւ	np.	Bacchus, Dionysus.
Բելփեգովր	րայ	np.	Belphegor.
Բեկտոր	րիւ	np.	Victor.
Բենեդիկտոս	սիւ	np.	Benedictus.
Բենիամին	նիւ	np.	Benjamin.
Բեռնարդոս	սիւ	np.	Bernard.
Բերենիկէ	կեայ	np.	Berenice.
Բերոս	սիւ	np.	cf. Բիւռիոս.
Բերիոս	սիւ	np.	cf. Բիւռիոս.
Բերոսոս		np.	cf. Բիւռիոս.
Բիւռիոս		np.	Berossus, Berosus.
Բերսաբէ	բեայ	np.	Bersabée.
Բէլ	լայ	np.	Bel, Belus.
Բիւրասպի	պեայ	np.	Piurasby, Byraspy.
Բոնավենտուրա	այ	np.	cf. Պոնավենդուրա.
Բրիգիտա	այ	np.	Bridget.
Բրունոն	նիւ	np.	Bruno.
Բրուտոս	սիւ	np.	Brutus.
Գաբինիոս	սիւ	np.	Gabinius.
Գաբրիէլ	լիւ	np.	Gabriel.
Գալանոս	սիւ	np.	Galano.
Գալբա	այ	np.	Galba.
Գալիլէոս	սիւ	np.	Galilee.
Գաղենոս	սիւ	np.	Galenus.
Գաղիղեա		np.	cf. Գալիլէոս.
Գամաղիէլ	լիւ	np.	Gamaliel.
Գայէտանոս	նեայ	np.	Caietanus.
Գայիանէ	նեայ	np.	Gayané.
Գանիմեդէս	դեայ	np.	Ganymede.
Գառնիկ	նկայ	np.	Garnik.
Գասպար	րայ	np.	Gaspard.
Գարեգին	գնիւ	np.	Karekin.
Գեդէոն	նիւ	np.	Gideon, Gedeon.
Գելասիոս	սիւ	np.	Gelasius.
Գեղամ	մայ	np.	Keram.
Գենատիոս	սիւ	np.	Gennadius.
Գենարոս	սիւ	np.	Januarius.
Գերարդոս	սիւ	np.	Gérard.
Գերմանիկոս	սիւ	np.	Germanicus.
Գերմանոս	սիւ	np.	Germain.
Գէորգ	գայ	np.	George.
Գիլբերտոս	սիւ	np.	Gilbert.
Գիլիպպոս	պեայ	np.	Gylippus.
Գիսակ	կայ	np.	Gisak.
Գիսանէ	նեայ	np.	Gisane.
Գիւտ	տայ	np.	Giwd.
Գնէլ	լայ	np.	Gnel.
Գուլիէլմոս	մայ	np.	William.
Գրատիանոս	սիւ	np.	Gratianus
Գրիգոր	րիւ	np.	Gregory; — Լուսաւորիչ, — the Illuminator; — Նարեկացի, — of Narek; — Նազիանզացի, — of Nazianzus; — Նիւսացի, — of Nyssa.
Գրիգորիոս	սիւ	np.	cf. Գրիգոր.
Գրիգորիս	սիւ	np.	cf. Գրիգոր.
Դադան	նայ	np.	Dathan.
Դամասոս	սիւ	np.	Damasus.
Դամոն	նիւ	np.	Damon.
Դան	նայ	np.	Dan.
Դանիէլ	լիւ	np.	Daniel.
Դարեհ	հիւ	np.	Darius.
Դաւիթ	ւթայ	np.	David.
Դափնէ	նեայ	np.	Daphne.
Դեդաղոս	ղեայ	np.	Daedalus.
Դեմետր	րեայ, րի	np.	Demeter.
Դեմետրիոս		np.	Demetrius; cf. Դեմետր.
Դեմոկրիտոս	տեայ	np.	Démocritus.
Դեմոսթենէս	նեայ	np.	Demosthenes.
Դեւկալիոն	նիւ	np.	Deucalion.
Դիագորաս	րայ	np.	Diagoras.
Դիդէ	դեայ	np.	Dido.
Դիոգինէս	նեայ	np.	Diogenes.
Դիոդորոս	րի	np.	Diodorus.
Դիոկղետիանոս	սիւ	np.	Diocletian.
Դիոն	նիւ	np.	Dion.
Դիոնէսիոս	սիւ	np.	Dionysus.
Դիոնիսի	նիսեայ	np.	Bacchus.
Դիոս	իայ	np.	Jupiter.
Դիոսկորոս	սիւ	np.	Dioscorus.
Դոմետիանոս	սիւ	np.	Domitian.
Դոմինիկոս	սիւ	np.	Dominic.
Դորոթէոս	սիւ	np.	Dorotheus.
Եգեսիպպոս	պպեայ	np.	Hegesippus.
Եգիդիոս	սիւ	np.	Aegidius.
Եդիպոս	պեայ	np.	Oedipus.
Եդուարդ	դայ	np.	Edward.
Եզեկիա	այ	np.	Hezekiah.
Եզեկիէլ	լիւ	np.	Ezekiel.
Եզնիկ	նկայ	np.	Eznik.
Եզր	րիւ	np.	Ezra.
Եղիա	այի	np.	Elijah.
Եղիազար	րու, րաւ	np.	Eleazar.
Եղիշէ	էիւ	np.	Elisha.
Եղիսաբեթ	թիւ	np.	cf. Եղիսաբէթ.
Եղիսաբէթ	թիւ	np.	Elizabeth.
Եղիսէ	էիւ	np.	Elishah.
Եմիղիոս	ղեայ	np.	Emilius.
Եմպետոկղ	ղիւ	np.	Empedocles.
Ենէաս	նեայ՝ սայ	np.	Aeneas.
Եննովկենտիոս	սիւ	np.	Innocent.
Ենովս	սայ	np.	Enos.
Ենովք	քայ	np.	Enoch.
Եպամինոնդաս	այ	np.	Epaminondas.
Եպիկուրոս	րայ՝ սիւ	np.	Epicurus.
Եպիկտետոս	սիւ	np.	Epictetus.
Եպիմենիդէս	դեայ	np.	Epimenides.
Եպիփան	նու	np.	Epiphanius.
Եսայի	յեայ	np.	Isaias.
Եսաւ	ւայ	np.	Esau.
Եսթեր	րայ	np.	Esther.
Եսիոդոս	դեայ	np.	Hesiodus, Hesiod.
Եսովպոս	սիւ	np.	Aesop.
Եսքինէս	նեայ	np.	Aeschines.
Երանեակ	եկայ	np.	Fortunate, Felicity.
Երանուհի	հւոյ	np.	Felicia.
Երանոս	սիւ	np.	Eranos.
Երասմոս	սիւ	np.	Erasmus.
Երատոստենէս	նեայ	np.	Eratosthenes.
Երեմիա	այ	np.	Jeremiah.
Երուանդ	դայ	np.	Eruand.
Եւայ	յիւ	np.	Eve.
Եւագոր	րայ	np.	Evagoras.
Եւագր	րի	np.	Evagrius.
Եւդոքսիա	այ	np.	Eudoxia.
Եւկղիդէս	դեայ	np.	Euclid.
Եւմենէս	նեայ	np.	Eumenes.
Եւնոմիոս	մեայ	np.	Eunomius.
Եւողոս	սիւ, ղեայ	np.	Aeolus.
Եւսդաքիոս	սիւ	np.	Eustace.
Եւսեբիոս	բի՝ սի	np.	Eusebius.
Եւտիքական	նի	np.	Eutychian.
Եւտիքէս	քեայ	np.	Eutychius.
Եւտրոպիոս	սիւ	np.	Eutropius.
Եւրիդիքէս	քեայ	np.	Eutichète.
Եւրիդիկէս	կեայ	np.	Eurydice.
Եւրիպիդէս	դեայ	np.	Euripides.
Եփեստոս		np.	cf. Հեփեստոս.
Եփրեմ	մի	np.	Ephraim.
Զապէլ	լայ	np.	Isabelle.
Զարեհ	հի	np.	Zareh.
Զարմայր	րայ	np.	Zarmaïr.
Զաւան	նայ	np.	Zavan.
Զաքարիա	այ	np.	Zechariah.
Զաքէոս	սիւ	np.	Zacchaeus, Zaccheus.
Զենոբ	բայ	np.	Zenobius.
Զենոն	նիւ	np.	Zeno.
Զեւս	սայ	np.	Zeus, Jupiter.
Զոյիլոս	սիւ, լեայ	np.	Zoilus.
Զրադաշտ	սիւ	np.	Zoroaster.
Զրուան	նայ	np.	Saturn.
Զօրաբաբէլ	լիւ	np.	Zerubbabel.
Թադէոս	սիւ	np.	Thaddeus.
Թաթուլ	թլոյ	np.	Tatul.
Թաղէս	ղեայ	np.	Thales.
Թարայ	յիւ	np.	Terah.
Թարշիշ	շշի, շշայ	np.	Tarsus; ակն Թարշշի, jacinth, precious stone of a flame colour.
Թարսիս	սսի, սսայ	np.	cf. Թարշիշ.
Թեկղի	ղեայ	np.	Thecla.
Թերեսիա	այ	np.	Teresa.
Թերսիտէս	տեայ	np.	Thersites.
Թեւտոնք	նից	np.	Teutons.
Թէոդոս	սիւ	np.	Theodosius.
Թէոդորոս	սիւ	np.	Théodore.
Թէոփիլէ	լեայ՝ լէի	np.	Theophilus.
Թեոփիղոս			<ab>np.</a> cf. Թէոփիլէ.
Թէփրաստոս	տեայ	np.	Theophrastus.
Թոնդրակեցի	ցւոյ	np.	Thondrageci.
Թոռնիկ	նկայ	np.	Thornig.
Թովմաս	այի՝ ասու	np.	Thomas.
Թորգոմ	մայ	np.	Togarmah.
Թուրք	քաց	np.	Turcs.
Իբրահիմ	մայ	np.	Ibrahim.
Իգնատիոս	սիւ	np.	Ignatius.
Ինաքոս	սիւ	np.	Inachus.
Իսահակ	կայ	np.	Isaac.
Իսիդորոս	սիւ	np.	Isidore.
Իսմայէլ	լիւ	np.	Ishmael.
Իսոկրատ	տայ	np.	Isocrates.
Իսրայէլ	լիւ	np.	cf. Իսրայէղ
Իսրայէղ	ղիւ	np.	Israël.
Իրենէոս	սիւ	np.	Irenaeus
Իրենէս	նեայ	np.	Irene.
Իրիս	րեայ	np.	Iris.
Իփիկրատ	տայ	np.	Iphicrates.
Լաբան	նայ	np.	Laban.
Լակտանտիոս	սիւ	np.	Lactantius.
Լանկթամուր	րայ	np.	Tamerlane.
Լապիթեայք	յց	np.	Lapiths.
Լաոքոնտ	տեայ	np.	Laocoön.
Լաւոմետոն	նայ	np.	Laomedon.
Լաւրենտիոս	սիւ	np.	Lawrence.
Լեւկիպպոս	սիւ	np.	Leucippus.
Լեւոնիդաս	սայ	np.	Leonidas.
Լեւոն	նիւ	np.	Leon.
Լէոն	նիւ	np.	cf. Լեւոն.
Լեոբոլտ	տայ	np.	Leopold.
Լիա	այ	np.	Leah.
Լիկիանոս	նեայ	np.	Licinius.
Լիկուրգոս	գեայ	np.	Lycurgus.
Լիվիոս	սիւ	np.	Livy.
Լիւսանդր	րիւ	np.	Lysander.
Լիւսիմաք	քեայ	np.	Lysimachus.
Լիւսիպպոս	սիւ	np.	Lysippos.
Լուդովիկոս	սիւ	np.	cf. Լուդովիկ.
Լուկրետիոս	սիւ	np.	Lucretius.
Լուտեր	րիւ	np.	Luther.
Լոք	քայ	np.	Locke.
Լոքման	նայ	np.	Lockman.
Խաչատուր	տրոյ	np.	Khachatur.
Խոսրով	ու, այ	np.	Khosrov.
Խոսրովիդուխտ	դխտոյ	np.	Khosrovidukht.
Խորենացի	ցւոյ	np.	of Khoren
Խորէն	նայ	np.	Khoren.
Կադմոս	մեայ	np.	Cadmus.
Կաղիմաքոս	քեայ	np.	Callimachus
Կալվին	վնոյ	np.	Calvin.
Կամբիւսէս	ւսեայ	np.	Cambyses.
Կամսար	րայ	np.	Camsarus.
Կայէն	նիւ	np.	Cain.
Կայիափայ	այ, այի	np.	Caiaphas.
Կայնան	նայ	np.	Kenan.
Կատարինէ	նեայ	np.	Katherine.
Կատիլինա	այ	np.	Catiline.
Կատոն	նիւ	np.	Caton.
Կարապետ	տիւ	np.	Garabed.
Կարդոս	սիւ	np.	Cardo.
Կարէն	նիւ	np.	Karen.
Կարոլոս	սիւ	np.	Charles.
Կեկրոպ	պայ	np.	Cecrops.
Կեսար	րու	np.	Caesar; Յուլիոս —, Julius —.
Կեսներ	րի	np.	Gessner.
Կերինտոս	տեայ	np.	Cerinthus.
Կիաքսար	րայ	np.	Cyaxares.
Կիկերոն	նիւ	np.	Cicero.
Կիկղոպայք	յց	s. np.	Cyclops.
Կերթուզեանք	նց	np.	Carthusians.
Կիմոն	նիւ	np.	Cimon.
Կիպրիանոս	սիւ	np.	Cyprian.
Կիրակոս	սիւ	np.	Cyriacus.
Կիւրեղէ	ղեայ	np.	Cybele.
Կիւրեղ	րղիւ	np.	Cyril.
Կիւրոս	սիւ	np.	Cyrus.
Կղարք	քայ	np.	Clarke.
Կղաւդոս	դեայ	np.	Claudius.
Կղէոպատրա	այ	np.	Cleopatra.
Կղեմէս	մայ	np.	Clement.
Կղէարքոս	քեայ	np.	Clearchus.
Կղէոբուղ	ղեայ	np.	Cleobulus.
Կղիմաքոս	քեայ	np.	Climacus.
Կղոդիոս	դեայ	np.	cf. Կղաւդոս.
Կոդրոս	սիւ	np.	Codrus.
Կոզմաս	այ, այիւ	np.	Cosmo, Cosmus.
Կոմիտաս	սայ	np.	Komitas.
Կոմնէնոս		np.	Komnenos.
Կոնոն	նիւ	np.	Conon.
Կոնփուկիոս	սի	np.	Confucius.
Կոռնակ	կայ	np.	Kornak.
Կոստանդ		np.	Constantius.
Կոստանդիանոս	սիւ	np.	Constantine.
Կոստանդին	դնիւ	np.	cf. Կոստանդիանոս.
Կոստանտոս	տեայ	np.	Constantius.
Կոստաս	սայ	np.	cf. Կոստանտոս.
Կորէ		np.	Proserpine.
Կորիողանոս	սիւ	np.	Coriolanus.
Կորիւն	նոյ	np.	Koriun.
Կորխ	խայ	np.	Core.
Կուինտիլիանոս	սիւ	np.	Quintilian.
Կուռնելիոս	լեայ	np.	Cornelius.
Կուրտիոս	սիւ	np.	Curtius.
Կտեսիաս	այ	np.	Ctesias.
Կրասոս	սիւ	np.	Crassus.
Կրատիպպոս	պեայ	np.	Cratippus.
Կրեսոս	սիւ	np.	Croesus.
Կրիսիպպոս	պպեայ	np.	Chrysippus.
Համազասպ	պայ	np.	Hamazasp.
Համամ	մայ	np.	Hamam.
Համան	նայ	np.	Haman, Aman.
Հայկ	ի, իւ, այ, աւ	s.	Hayk.
Հասան	նայ	np.	Hassan.
Հաւանակ	կայ	np.	Havanak.
Հեթում	թմոյ	np.	Hethum.
Հելլէնք	նաց	np.	Helen.
Հելվետիոս	սիւ	np.	Helvetius.
Հեկտոր	րիւ	np.	Hector.
Հեղինէ	նեայ	np.	cf. Հելլէնք.
Հեղիոդորոս	րայ	np.	Heliodorus.
Հենրիկոս	կեայ	np.	Henry.
Հերա	այ	np.	Hera.
Հերակլ	լիւ	np.	Heraclius.
Հերակլէս	լեայ	np.	Heracles.
Հերակղիդէս	դեայ	np.	Heracleidae.
Հերակղիտոս	տեայ	np.	Heraclitus.
Հերմէս	մեայ, մեսի	np.	Hermes.
Հերոնիմոս	նեայ, սի	np.	Jerome, Hieronymus.
Հերոդոտոս	տեայ	np.	Herodotus.
Հերովդէս	դէի, դի	np.	Herod.
Հերքիւղէս	լեայ	np.	cf. Հերակլէս.
Հիլարիոս	սիւ	np.	Hilarius
Հիմէն	նայ	np.	Hymen.
Հիպոկրատ	տայ	np.	Hippocrates.
Հիւպպողիտոս	տեայ	np.	Hippolyte.
Հիւրկանոս		np.	Hyrcanus.
Հողեփեռնէս	նեայ	np.	Holofernes.
Հոմեր	իւ	np.	Homer.
Հոմերոս	իւ	np.	cf. Հոմեր.
Հոմերոն	իւ	np.	cf. Հոմեր.
Հոնք	նաց	np.	Huns.
Հռաքէլ		np.	cf. Հռաքէղ.
Հռաքէղ	ի, այ	np.	Rachel.
Հռեգուղոս	ղեայ	np.	Regulus.
Հռեմոս	սիւ	np.	Remus.
Հռիփսիմէ	մեայ	np.	Hripsime.
Հռոմուլոս	լեայ	np.	Romulus.
Հռութ		np.	Ruth.
Հրէայ	րէիւ	np.	cf. Հրէայ.
Ձագ	գայ	np.	Zack.
Ղազար	րու	np.	Lazarus.
Ղազարոս	սիւ	np.	cf. Ղազար.
Ղամէք	քայ	np.	Lamech.
Ղեւի	ւեայ	np.	Levi.
Ղեւոնդ	դիւ	np.	Leo
Ղինոս	սայ	np.	Linus.
Ղոնգինոս	սիւ	np.	Longinus.
Ղովտ	տայ	np.	Loth, Lot.
Ղուկաս	սու, կայ	np.	Luke.
Ղուկուղղոս	ղեայ	np.	Lucullus.
Ղունկիանոս	սիւ	np.	Lucian.
Ճինկիզխան	նայ	np.	Genghis Khan.
Մաթուսաղայ	յիւ	np.	Methuselah.
Մակար	րայ	np.	Macarius.
Մակեդոն	նիւ	np.	Macedonius.
Մակեդոնեանք	նց	np.	Macedonian.
Մահմետականք	նաց	np.	Mohammedan.
Մահմէտ	տիւ	np.	Muhammad.
Մաղաքիա	այ	np.	Malachi.
Մաղթեղջիւր	ջեր	np.	Amalthea.
Մաղքոս	սիւ	np.	Malchus.
Մամբրէ	էիւ	np.	Mamre.
Մանասէ	էիւ	np.	Manasseh.
Մանաւազ	զայ	np.	Manawaz.
Մանի	նեայ	np.	Mani.
Մանիքեցիք	ցւոց	np.	Manicheans.
Մանուէլ	լիւ	np.	Emanuel.
Մանուշակ	կայ	np.	Manušak.
Մաշտոց	ցի	np.	Mashtots.
Մապիյլեօն	նիւ	np.	Mabillon.
Մասիյլեօն	նի	np.	Massillon.
Մասկարոն	նիւ	np.	Mascaron.
Մատաթիա	այ	np.	Matthias.
Մատաթիաս	այ	np.	cf. Մատաթիա.
Մատթէոս	սիւ, էիւ	np.	Matthew.
Մարգարիտ	տայ	np.	Margaret.
Մարթայ	յիւ	np.	Martha.
Մարիամ	մու, րեմու, րեմայ	np.	Mary.
Մարիբաս	բայ, սայ	np.	Maribas.
Մարկիովն	նիւ	np.	Marcion.
Մարկիովնացիք	ցւոց	np.	Marcionit.
Մարկոս	սիւ	np.	Mark.
Մարովդաք	քայ	np.	Merode.
Մարտիաղէս	ղեայ	np.	Martial.
Մարտիրոս	սիւ	np.	Martyr.
Մարք	րաց	np.	Mahdi.
Մաքսիմիանոս	սիւ	np.	Maximian.
Մաքսիմոս	սիւ	np.	Maximus.
Մեդացի	ցւոյ	np.	Medus.
Մեդուսա	այ	np.	Medusa.
Մեդք	դաց	np.	cf. Մարք.
Մելիտոս	սի	np.	Mellitus.
Մելպոմեն	նայ	np.	Melpomene.
Մելքիսեդեկ	կի	np.	Melchizedek.
Մեկենաս	սայ	np.	Maecenas.
Մենանդրոս	սիւ	np.	Menander.
Մենեղաւոս	սիւ	np.	Menelaus.
Մենտոր	րիւ	np.	Mentor.
Մեռկեռիոս	սիւ	np.	Mercury.
Մեսիայ	յիւ	np.	Messiah.
Մեսրոպ	պայ	np.	Mesrop.
Մետեղղոս	ղեայ	np.	Metellus.
Մետրոփանէս	նեայ	np.	Metrophanes.
Մերուժան	նայ	np.	Meruzhan
Միլետոս	սիւ	np.	Miletus.
Միղոն	նիւ	np.	Milo.
Միլտովն	նի	np.	Milton.
Միհրան	նայ	np.	Mihran.
Միհրդատ	տայ	np.	Mithridates.
Մինաս	սայ	np.	Minas.
Մինովս	սայ	np.	Minos.
Միքայէլ	լիւ	np.	Michael.
Միքիաս	այ	np.	Micah.
Մխիթար	րայ	np.	Mkhitar.
Մկրտիչ	տչի	np.	Baptist.
Մշակ	կայ	np.	Mshak.
Մոլիէռ	ռայ	np.	Molière.
Մողոլք	լաց	np.	Moloch.
Մոնֆոքոն	նիւ	np.	Montfaucon.
Մոսկովք	վաց	np.	cf. Ռուսք.
Մովաբ	բու	np.	Moab.
Մովաբացի		np.	Moabita.
Մովսէս	եսի, իսի, սիւ	np.	Moses; — Խորենացի, Moses Khorenatsi.
Մուկիոս Սկեվոլա	այ	np.	Mucius Scaevola.
Մուշեղ	ղայ	np.	Mushegh.
Մուստաֆայ	յիւ	np.	Mustafa.
Մուրատ	տայ	np.	Murad.
Մուրդքէ	էիւ	np.	Mordecai.
Մօրիկ	րկայ	np.	Maurice.
Յաբէթ	թիւ	np.	Japheth.
Յազկերտ	տիւ	np.	Yazdegerd.
Յակոբ	բայ (նահապետն)	np.	Jacob.
Յակոբ	բայ, բու (առաքեալն)	np.	Jake.
Յակոբոս	բայ, բու	np.	Jake.
Յակովբ	բայ, բու	np.	cf. Յակոբոս.
Յակովբոս		np.	cf. Յակովբ.
Յանոս	սիւ	np.	Janus.
Յանսենիոս	սիւ	np.	Jansen.
Յանսենեանք	նց	np.	Jansenite.
Յասոն	նիւ	np.	Jason.
Յարութիւն	նիւ	np.	Pascal.
Յեզաբէլ	լայ	np.	Jezebel.
Յէու	ւայ	np.	Jehu.
Յեսու	ւայ	np.	Joshua.
Յերոբովամ	մայ	np.	Jeroboam.
Յեփթայէ	յեայ	np.	Jephthah.
Յիսուս	ի, իւ	s. np.	Jésus.
Յոբ	բայ	np.	Job.
Յոբնաղ	ղիւ	np.	Juvenal.
Յոհաննէս	ննու	np.	cf. Յովհաննէս.
Յոհան Ոսկեբերան		np.	John Chrysostom
Յոհաննա	այ	np.	Joan.
Յոյն	նիւ	np.	Greek.
Յոնիա	այ	np.	Ionia.
Յովաբ	բայ	np.	Joab.
Յովնաթան	նայ	np.	Jonathan.
Յովակիմ	մայ	np.	Joachim.
Յովաս	սայ	np.	Jehoash.
Յովաքազ	զայ	np.	Jehoahaz.
Յովէլ	լայ	np.	Joel.
Յովիանոս	սիւ	np.	Jovian.
Յովհան	ննու	np.	cf. Յովհաննէս.
Յովհաննէս	ննու	np.	John.
Յովնան	նու	np.	Jonah.
Յովսափատ	տայ	np.	Jehoshaphat.
Յովսեպոս	սիւ	np.	Josephus.
Յովսէփ	փայ, փու	np.	Joseph; Յովսէփ Արեմաթացի, Joseph of Arimathea.
Յովսէս		np.	Joset, José.
Յովսիա	այ	np.	Josiah.
Յովսիմոս		np.	Zosimos.
Յովրամ	մայ	np.	Jehoram.
Յուգուրթ	թայ	np.	Jugurtha.
Յուդայ	յիւ	np.	Juda.
Յուդիթ	դթայ	np.	Judith.
Յուլիանոս	սիւ	np.	Julianus.
Յուլիոս	լեայ	np.	Julius.
Յուղիտայ	ի	np.	Jule, Julie.
Յուսիկ	սկան	np.	Hesychius.
Յուսուփ	սփայ	np.	Jousouph.
Յուստիանէ	նեայ	np.	Justina.
Յուստիանոս	սիւ	np.	Justinian.
Յուստինոս	սիւ	np.	Justin.
Նաբաղ	ղայ	np.	Nabal.
Նաբովթ	թայ	np.	Naboth.
Նաբուգոդոնոսոր		np.	Nebuchadnezzar.
Նաբուպաղսար	րայ	np.	Nabopolassar.
Նաթան	նայ	np.	Nathan.
Նաւում	մայ	np.	Nahum.
Նեբրովթ	թայ	np.	Nimrod.
Նեեման	նայ	np.	Naaman.
Նեեմի	մեայ	np.	Nehemiah.
Նեղոս	սիւ	np.	Nilus.
Նեստոր	րիւ	np.	Nestor.
Նեստորեանք	նց	np.	Nestorian.
Ներոն	նիւ	np.	Nero.
Ներուաս	սայ	np.	Nerva.
Ներսեհ	հիւ	np.	Narseh.
Ներսէս	սիւ	np.	Nerses.
Նեքաւով	վայ	np.	Necho.
Նիկանովր	րայ	np.	Nicanor.
Նիկեփոր	րայ	np.	Nikephoros.
Նիկոդեմոս	մայ, սիւ	np.	Nicodemus.
Նիկողայոս	սիւ	np.	Nicholas.
Նիկոն	նիւ	np.	Nicon.
Նինոս	սիւ	np.	Ninus.
Նինուաս	սայ	np.	Ninias.
Նիոբէ	բեայ	np.	Niobe.
Նիւքար	իայ	np.	Nucar.
Նոյ	յի	np.	Noah.
Նոյեմզար	րայ	np.	Noemzara.
Նովատիանոս	սիւ	np.	Novatian.
Նումերիանոս	սիւ	np.	Numerian.
Նունէ	նեայ	np.	Nino.
Շահան		np.	cf. Շահանշահ.
Շահանշահ	հիւ	np.	Shahan.
Շաղիտայ	յիւ	np.	Salita.
Շամբաթ	թի	np.	Shambat.
Շամիրամ	մայ	np.	Semiramis.
Շապուհ	պհոյ	np.	Shapur, Sapor.
Շարայ	յիւ	np.	Sarah.
Շմաւովն		np.	cf. Սիմովն.
Շուշան	նայ	np.	Susanna.
Ոդիսեւս	իսեայ	np.	Odysseus.
Ոլոմպիադորոս	րայ	np.	Olympiodorus.
Ոկտաւիոս	իայ	np.	Octavius.
Ողիւմպիա	այ	np.	Olympus.
Ոնեսիմոս	մեայ	np.	Onesimus.
Ոնորիոս	սիւ	np.	Honorius.
Ոսկի	կւոյ, կեայ	np.	Oski.
Ոսման	նայ	np.	Osman.
Ովիդիոս	դեայ	np.	Ovid.
Ովսէէ	սեայ, սէի	np.	Hosea.
Ովրատիոս	տեայ	np.	Orazio.
Ովրեստէս	տեայ	np.	Orestes.
Ովքոս	սիւ	np.	Ochus.
Որմիզդ	մզդի, մզդայ	np.	Hormisdas (roi); Ahura Mazda (god).
Որոգինէս	նեայ	np.	Origen.
Որփէոս	սիւ	np.	Orpheus.
Ուսերիոս	սի	np.	Usserius.
Ուրբանոս	նեայ	np.	Urbanus.
Ոքոզիա	այ	np.	Ahaziah.
Չեչիլիա	այ	np.	Cécile.
Պանդալէոն	լէոնիւ	np.	Pantaleon.
Պապ	պայ	np.	Pap.
Պարթեւք	ւաց	np.	Parthian.
Պարիս	սայ	np.	Paris.
Պարսք	սից	np.	Persian.
Պարսիկ	սկի, սկաց	np.	Persia.
Պաւղոս		np.	Paul.
Պաւսանիաս	այ	np.	Pausanias.
Պեղագիա	այ	np.	Pelagia.
Պեղագիոս	սիւ	np.	Pelagius.
Պեղոպիդաս	դեայ	np.	Pelopidas.
Պետաւիոս	սիւ	np.	Petavius.
Պետրոս	սի	np.	Peter.
Պենելովպէ	պեայ	np.	Penelope.
Պետրոս	ի	np.	Pierre.
Պերդիկկաս	այ	np.	Perdiccas
Պերոզ	զի	np.	Peroz.
Պերիկղէս	ղեայ	np.	Pericles.
Պերսէոս	սիւ	np.	Perseus.
Պէգասոս	սիւ	np.	Pegasus.
Պէռփեռուժէն	նայ	np.	Porphyrogennetos.
Պիգասոս		np.	cf. Պէգասոս.
Պիգմալիոն	նիւ	np.	Pygmalion.
Պիղատոս	սիւ	np.	Pilate.
Պինդար	րեայ	np.	Pindar.
Պիոս	սիւ	np.	Pius.
Պիւթագոր	րայ	np.	Pythagoras.
Պիւթիա	այ	np.	Pythia.
Պիւռոն	նիւ	np.	Pyrrho.
Պիւռոս	սիւ	np.	Pyrrhus.
Պլինիոս	սիւ	np.	Pliny.
Պլուտարքոս	քեայ	np.	Plutarch.
Պղատոն	նիւ	np.	Plato.
Պղաւտոս	տեայ	np.	Plautus.
Պղուտոն	նիւ	np.	Pluto.
Պողեմոն	մոնի	np.	Polemon.
Պողիբիոս	սիւ	np.	Polybius.
Պողիկարպոս	սիւ	np.	Policarpo.
Պողիկրատէս	տեայ	np.	Polycrates.
Պոմոնա	այ	np.	Pomona.
Պոմպէոս	էիւ	np.	Pompey.
Պոմպոնիոս	սիւ	np.	Pomponius.
Պոսիդոն	նիւ	np.	Neptune.
Պոսիդոնիոս	սիւ	np.	Posidonius.
Պոսուէթ	թայ	np.	Bossuet.
Պորփիւր	րիւ	np.	Porphyry.
Պուալօ	օյիւ	np.	Boileau.
Պուրտալու	ւի	np.	Bourdaloue.
Պռիամոս	սիւ, մու	np.	Priam.
Պտղոմէոս	մեայ	np.	Ptolemy.
Պրոկղ	ղիւ	np.	Proculus.
Պրոկոպիոս	սիւ	np.	Procopius.
Պրոմիթէոս	թեայ	np.	Prometheus.
Պրոպերտիոս	սիւ	np.	Propertius.
Պրոտէոս	սիւ	np.	Proteus.
Պրոտեւս	սիւ	np.	cf. Պրոտէոս.
Պրոտագորաս	այ	np.	Protagoras.
Պրուգենտիոս	տեայ	np.	Prudencio
Պօղոս	սիւ	np.	cf. Պաւղոս.
Պօքքաչչիօ	օյիւ	np.	Boccaccio.
Ռախաբ	բայ	np.	Rahab.
Ռասին	նի	np.	Racine.
Ռափայէլ	լիւ	np.	Raphael.
Ռաքէլ	լայ	np.	cf. Հռաքէղ.
Ռեբեկա	այ	np.	Rebecca.
Ռենեառ	սիւ	np.	Regnard.
Ռոբովամ	մայ	np.	Rehoboam.
Ռոմանոս	սի	np.	Romanus.
Ռոքոս	սիւ	np.	Roch.
Ռուբէն	ենի, նիւ	np.	Reuben.
Ռուբինոս	սիւ	np.	Rubinus.
Ռուսօ	օյիւ	np.	Rousseau.
Ռօլէն	նիւ	np.	Rollin.
Սաբէլ	լիւ	np.	Sabellius.
Սադուկեցի	ցւոյ, ցւոց	np.	Sadducees.
Սաթինիկ	նկան	np.	Satenik.
Սալադին	նայ	np.	Saladin.
Սալուստիոս	սիւ	np.	Sallustius.
Սահակ	կայ	np.	Isaac.
Սաղմանասար	րայ	np.	Shalmaneser.
Սաղոմոն	իւ	np.	cf. Սողոմովն.
Սամարիա	իա, եայ	np.	Samarie.
Սամուէլ	լիւ	np.	Samuel.
Սամփսոն	նիւ	np.	Samson.
Սանատրուկ	րկոյ	np.	Sanatruk.
Սանդուխտ	դխտոյ	np.	Sanduxt.
Սառա	յիւ	np.	cf. Շարայ.
Սասան	նայ	np.	Sasan.
Սարգիս	գսիւ	np.	Serge.
Սարդանաբաղ	ղայ	np.	Sardanapale.
Սաւուղ	ղայ	np.	Saul.
Սափփով	վայ	np.	Sappho.
Սեբաստիանոս	սիւ	np.	Sebastian.
Սեբերիանոս	սիւ	np.	Sévérianus.
Սելեւկոս	կեայ	np.	Seleucus.
Սեղբեստրոս	սիւ	np.	Sylvester.
Սելիմ	մայ	np.	Selim.
Սենեքայ	յիւ	np.	Seneca.
Սենեքերիմ	մայ	np.	Sennacherib.
Սենեէր	րիւ	np.	Segneri.
Սեսոստր	րիւ	np.	Senusret.
Սէթ	թայ	np.	Seth.
Սէմ	մայ	np.	Shem.
Սիբիլլա	այ	np.	Sibyl.
Սիմէովն	նիւ	np.	Simeon.
Սիմովն	նիւ	np.	cf. Սիմովն.
Սիմոնիդէս	դեայ	np.	Simonides.
Սիսակ	կայ	np.	Sisak.
Սիստոս	սիւ	np.	Sistos.
Սիւլէյման	նայ	np.	Suleiman.
Սկիպիոն	նիւ	np.	Scipio.
Սկիւթացի	ցւոյ	np.	Scythe.
Սկիւթացիք	ցւոց	np.	Scythes.
Սմբատ	տայ	np.	Smbat.
Սոզոմենոս	նայ	np.	Sozomen.
Սոկիանոս	նեայ	np.	Socianus.
Սոկինեան		np.	Socinianian.
Սոկինոս	նեայ	np.	Socinus.
Սոկրատ	տայ	np.	Socrates.
Սողոմովն	նիւ	np.	Salomon.
Սողոն	նիւ	np.	Solon.
Սուարէզ	զի	np.	Suárez.
Սուիդաս	սայ	np.	Suda.
Սուլպիկիոս	սիւ	np.	Sulpicius.
Սուրէն	նի, նայ	np.	Suren.
Սուրիոս	սիւ	np.	Surius.
Սուքիաս	սայ	np.	Sukias.
Սոփիա	այ	np.	Sophie.
Սոփոկղ	ղի	np.	Sophocles.
Սոփոնիա	այ, իոյ	np.	Zephaniah.
Սպեւսիպպոս	պեայ	np.	Speusippus.
Սպիրիդիոն	դիոնիւ	np.	Spiridion.
Ստեփաննոս	սիւ	np.	Stéphane.
Ստրաբոն	նիւ	np.	Strabo.
Սրապիոն	նիւ	np.	Serapion.
Վահագն	նիւ	np.	Vahagn.
Վահան	նայ	np.	Vahan.
Վահէ	հեայ	np.	Vahé.
Վահրամ	մայ	np.	Vahram, Bahram.
Վաղարշ	շայ	np.	cf. Վաղարշակ.
Վաղարշակ	կայ	np.	Vologases.
Վաղդանկ	կայ	np.	Valtango.
Վաղենտինոս	սիւ	np.	Valentin.
Վաղենտիանոս	նոսիւ	np.	Valentinian.
Վաղերիանոս	սիւ	np.	Valérian.
Վաղերիոս	սիւ	np.	Valerius.
Վաղէս	սիւ	np.	Valens.
Վանդալք	լաց	np.	Vandals.
Վառվառէ	ռեայ	np.	Barbara.
Վասակ	կայ	np.	Vasak.
Վասիլ	սլիւ	np.	cf. Բարսեղ.
Վարազդատ	տայ	np.	Varazdat.
Վարաժ	ժայ	np.	Varazhnuni.
Վարդ	դայ	np.	Rose.
Վարդան	նայ	np.	Vartan.
Վարդուհի	հեայ	np.	Rose.
Վարոս	սիւ	np.	Varus.
Վարրոն	նիւ	np.	Varro.
Վեսպասիանոս	սիւ	np.	Vespasian.
Վիկտոր	րիւ	np.	Victor.
Վինկենտիոս	տեայ	np.	Vincent.
Վիտրովիոս	վեայ	np.	Vitruvius.
Վիրգիլիոս	լեայ	np.	Virgil.
Վիրգինիա	այ	np.	Virginie.
Վիրք	վրաց	np.	Georgians.
Վլաս	սայ	np.	Blase.
Վշտասպ	պայ	np.	Hystaspes, Vishtaspa.
Վօլթէռ	ռի	np.	Voltaire.
Վռամշապուհ	պհոյ	np.	Vramshapuh.
Վրթանէս	նիսի, նայ	np.	Vrtanes.
Տաթեւ	ւայ	np.	Tatev.
Տակիտոս	սիւ	np.	Tacitus.
Տաճիկ	կճի	np.	Tajiks.
Տանդէ	էիւ	np.	Dante.
Տանտալ		np.	cf. Տանտաղոս.
Տանտաղոս	ղեայ	np.	Tantalus.
Տելեմաք	քայ	np.	Telemachus.
Տերենտիանոս	սիւ	np.	Terence.
Տերետիոս	սիւ	np.	cf. Տերենտիանոս.
Տերտիոս	սիւ	np.	Tertius.
Տերտուղիանոս	սիւ	np.	Tertullian.
Տիբերիոս	րեայ	np.	Tiberius.
Տիգրան	նայ	np.	Tigranes.
Տիգրանուհի	հւոյ	np.	Tigranouhie.
Տիմոթէոս	թեայ	np.	Timothy.
Տիպուղոս	ղեայ	np.	Tibullus.
Տիտոս	սիւ	np.	Titus.
Տիրիթ	թայ	np.	Tirith.
Տովբիթ	թայ	np.	Tobit.
Տուբիա	այ	np.	Tobias.
Տրայիանոս	սիւ	np.	Trajan.
Տրդատ	տայ	np.	Tiridates.
Ցոլակ	կայ	np.	Tsolak.
Փաբիոս	սիւ	np.	Fabius.
Փաբրիկիոս	կեայ	np.	Fabricius.
Փաղարիդէս	դեայ	np.	Phalaris.
Փաղերիոս	րեայ	np.	Phalerius.
Փայիթոն	նիւ	np.	Phaethon.
Փառանձեմ	մայ	np.	Pharantzem.
Փառնակ	կայ	np.	Pharnaces.
Փարաւովն	նիւ	np.	Pharaoh.
Փեթռառքա	այիւ	np.	Petrarch.
Փելիքս	սիւ	np.	Felix.
Փեստոս	սիւ	np.	Festus.
Փետրոս	սիւ	np.	Phaedra.
Փիլիպպոս	սիւ, պեայ	np.	Philip.
Փիլոկտէտ	տեայ	np.	Philoctetes.
Փիրմիղիանոս	նեայ	np.	Firmilian.
Փլաբիանոս	սիւ	np.	Flavian.
Փլամինիոս	նեայ	np.	Flaminius.
Փոկաս	սու, սայ	np.	Phocas.
Փոկիոն	նի	np.	Phocion.
Փոստոս	սիւ	np.	Fauste.
Փոտ	տայ	np.	Photius.
Փսամետիկոս	կեայ	np.	Psamtik.
Փրանկիսկոս	կոսիւ	np.	François.
Փրաւորտ	տայ	np.	Phraortes.
Քամ	մայ	np.	Ham.
Քանան	նու	np.	Canaan.
Քիապրէրա	այ	np.	Chiabrera.
Քիղոն	նիւ	np.	Chilon.
Քինալադան	նիւ	np.	Chinaladano.
Քլարա	այ	np.	Clara.
Քոլոմպոս	պեայ	np.	Columbus.
Քսանթիպպոս	պեայ	np.	Xanthippus.
Քսենոկրատ	տեայ	np.	Xenocrates.
Քսենոփան	նեայ	np.	Xenophanes.
Քսենոփոն	նիւ	np.	Xenophon.
Քսեստոս	սիւ	np.	Sixtus.
Քսերքսէս	քսիւ	np.	Xerxès.
Քրիստափոր	րիւ	np.	Christopher.
Քօռնէյլ	լայ	np.	Cornelius.
Օգոստինոս	սիւ	np.	Augustine.
Օգոստոս	տոսի, գոստեայ	np.	Augustus.
Օշին	շնիւ	np.	Oshin.
Օտայ	յիւ	np.	Ota.
Օքսէնտիոս	սիւ	np.	Auxence.
Ֆենելոն	նիւ	np.	Fénelon.
Ֆեռտինանտօ	օյիւ	np.	Ferdinand.
Ֆետերիկոս	սիւ	np.	Frederica.
Ֆիլիպ		np.	Փիլիպպոս.
Ֆլէշիէռ	ռայ	np.	Fléchier.
Ֆոհի	հեայ	np.	Fohi.
